מגישים:
אלינה פוליי 321123689
דרור אורי 204454110
אלון
טומי

אירועים המופעלים ע"י המשתמש:
fileRequest X - אירוע בקשה להורדת קובץ בגודל X
turnOn - אירוע הדלקת המכונה
turnOff - אירוע כיבוי המכונה
internetOn - אירוע התחברות לאינטרנט
internetOff - אירוע התנתקות מהאינטרנט
downloadAborted - אירוע ביטול ההורדה
downloadError - אירוע של תקלה בעת ההורדה
errorFixed - אירוע שהתקלה תוקנה
movieOn - אירוע הדלקת צפייה בסרט
restartMovie - אירוע איתחול הצפייה של הסרט
holdMovie - אירוע השהיית הסרט ע"י המשתמש
resume - אירוע החזרת הסרט לאחת ההשהייה
movieOff - אירוע כיבוי הצפייה בסרט 

setSpeed X - הגדרת מהירות ההורדה(מהירויות ההורדה בכל מקרה ישתנו בעקבות שינויים בסטטוס המשתמש)
setScore X - הגדרת הניקוד של המשתמש(הניקוד יתעדכן בכל מקרה ע"פ החוקים הנתונים) ברירת מחדל 0
setFreeSpace X - הגדרת הגודל הפנוי בדיסק(ברירת מחדל 100)

אירועים אוטומטיים במערכת:
when(score=4) - אירוע שהמשתמש צבר 4 נקודות ועליו לעבור לסטטוס מתקדם
when(score=7) - אירוע שהמשתמש צבר 7 נקודות ועליו לעבור לסטטוס מקצוען
when(score<4) - אירוע שהנקודות של המשתמש ירדו מתחת ל4 ועליו לחזור לסטטוס מתחיל
when(score<7) - אירוע שהנקודות של המשתמש ירדו מתחת ל7 ועליו לחזור לסטטוס מתקדם
entered finish download - אירוע של סיום ההורדה(מכבה את הצפייה בסרט)
entered download - אירוע של תחילת ההורדה
entered try to fix error - אירוע כאשר ארעה תקלה וכעת מנסים לתקן אותה